8
XXXXX#X.
X.......
XCX.X..X
X..O....
..XXXS..
.......^2
..@..^3..
.^0....^1.
....X...