26
.OOO....
.C..X...
XS..XCXX
^0....O..
...X..X.
.X....X.
.#....X.
..O...@O
^1.......