18
.......X..
..C.......
X.......C.
..C.......
.....P{8,8}....
........X.
.X..S.....
.....X...X
........P{5,4}.
X#X..@..O.