26
X.....XX
.O.^0CO..
........
X.....^2.
#..S....
X.......
X..C...O
X@...X..