13
.P{6,4}..^2...
........
....OO..
..SOC...
....OOP{1,0}.
....X...
....#...
........
@.X.....