13
X.....XX
.O..CO..
........
X.......
#..S....
X.......
X..C...O
X@...X..