9
. .  . X      .      .  X
. .  . P{4,4} .      .  #
X .  . .      .      .  X
. .  . X      .      .  .
. .  . .      P{3,1} .  .
. ^0 . .      .      ^1 .
. @  . X      .      .  .