11
.X.......
......X..
....X....
.....X..X
X...S..#X
..X...XX.
.X.....@.
...X.....