12
.X.#X......
.......XX..
.....X.X...
..X......XX
......X...X
.......X...
......@....
..X.X......
.....X.....
...S.......
.X......X..
.....X.....