6
. . . . . X . .
. . S . ^2X . .
. . X . . @ . .
. . . . . . X X
X . . O . . . .
. ^2. . ^3. # .
. . . . . . . .
. . . . O . . .
. . . . . . ^1.
X X . . . . . .