14
. . . . . . . . X X
. . . . . . . . . X
X ^1O . . ^0. . . .
. . . . . O X S . .
. . . X X . X . . .
X . . X . . . . ^2.
@ . . . . . X ^2. .
X ^0^1X . X X . . .
. . . . . . . . # .
. . . . ^2. ^1. ^2.
X . . . . . . . . .
. ^2. . . . . . X X