9
. . ^0. . . .
. . X . . @ X
. . . X S . .
X . . . . . .
. . . ^1. . X
^1X . X . X .
^3. O . . ^3.
. . . . ^0. .
# . ^0. . . .