6
. . X . . . . @
. . . . . . ^2.
. ^0. . . ^3. .
^0. . . . X . .
# . . . . . . .
^0. . . . . . .
. . . . ^0^1. .
. O . . ^2. . .
S . X . . X . .